Eye_Count,Vis_Count,MM_Count,Total_Count,Num_RQ,Ob_Ex,Perf
1,1,1,3,2,1,1
7,2,1,10,3,0,1
6,1,1,8,2,0,0
6,1,2,9,4,1,0
5,1,2,8,3,0,0
4,1,1,6,4,0,1
4,2,2,8,2,1,0
6,1,1,8,3,1,0
6,1,2,9,3,0,1
3,2,2,7,1,1,1
6,2,3,11,5,0,1
4,2,1,7,3,0,0
5,1,0,6,2,1,0
4,1,0,5,5,1,1
